s . w w . . . . w w w w
w . . w . w w . w w w w
w w . w . w w . w w w .
. . . w . w w . w w w .
. w w w . w w . w w w .
. . . . . w w . . . . .
. . . . . w w . w w . .
w w w w w w w . w w . .
w w w w w w w . . . . .
w . . . . . . . . . . .
w . . . . . . . . . . e
