b b b b b b b b b b b b b b b
b . . . b . . . . . b . . . b
b . w . b . w w w . b . w . b
b . w . b . w w w . b . w . b
b . w . b . w w w . b . w . b
b . w . b . w w w . b . w . b
b . w . b . w w w . b . w . b
b . w . . . b b b . . . w . b
b . w b b b s b e b b b w . b
b . w b w b . b . b w b w . b
b . w b w b . w . b w b w . b
b . w b w b . w . b w b w . b
b . w b w b . w . b w b w . b
b . . . . . . w . . . . . . b
b b b b b b b b b b b b b b b
